Level 0:	
1	 
Level 1:	
1	1	 
Level 2:	
1	4	1	 
Level 3:	
1	7	4	11	1	 
Level 4:	
1	11	15	32	34	26	1	 
Level 5:	
1	16	26	15	76	192	34	122	180	57	1	 
Level 6:	
1	22	42	56	156	474	267	294	426	1494	496	423	768	120	1	 
Level 7:	
1	29	64	98	56	288	1038	1344	768	855	1206	5142	2829	5946	496	2127	9204	4288	1389	2904	247	1	 
Level 8:	
1	37	93	162	210	491	2062	3068	1736	1806	4590	855	2934	14988	18864	20838	22680	7930	8157	43422	23349	70206	11056	9897	49569	28768	4414	10194	502	1	 
Level 9:	
1	46	130	255	372	210	787	3788	6426	8220	3868	11270	6326	7155	6371	38224	55328	31016	63456	156894	28665	28768	46470	25761	165978	203304	325500	346539	232216	11056	50682	316164	166314	635610	141584	44002	245148	166042	13744	34096	1013	1	 
